1111111111111
1P00110C00011
10010000000C1
100C0001110E1
1111111111111