111111111111111111111
1P000000100000000C001
100000010000001000001
1C11100000C0000000001
111000000000000000111
10001C1000011110000E1
111111111111111111111