1111111111111111111111111
1E0000000C00000C00000C001
1000010101101001000010101
1010001101010000100010101
1P00000C00C0000C0000000C1
1111111111111111111111111